111111111111111111111111111111111
1000E0000000100000000001111000001
1000000000001000C00C0001110000P01
100111111111111111000011100000001
100110C00000000000000001111100001
100111111111000111000000C00000001
100000000000000C00000000000000001
111111111111111111111111111111111